{
    "gates": [{
        "x": -32,
        "y": 32,
        "width": 32,
        "height": 32,
        "nivel_destino": "1",
        "destino_x": 1184,
        "destino_y": -1
    }],
    "coins": [
        [2, 1],
        [38, 2],
        [2, 15],
        [19, 13],
        [8, 1],
        [15, 9]
    ],
    "sierras": [
        [20, 10, 1, 150, 1, 0.08]
    ],
    "platforms": [
        [31, 10.5, 1, 50, 1, 0.05]
    ],
    "blocks": [
        [15, 0, 0, 4],
        [12, 5, 5, 4],
        [13, 0, 0, 4],
        [33, 5, 5, 6]
    ],
    "tile_size": 32,
    "columnas": 36,
    "filas": 16,
    "reaparicion_x": 1,
    "reaparicion_y": 1,
    "mapa": [
        0, 0, 0, 0, 0, 0, 0, 0, 0, 0, 0, 0, 0, 0, 0, 0, 0, 0, 0, 0, 0, 0, 0, 0, 0, 0, 0, 0, 0, 0, 0, 0, 0, 0, 0, 0, 21,
        1, 1, 1, 0, 0, 0, 0, 4, 1, 4, 0, 0, 0, 4, 4, 4, 4, 0, 0, 0, 0, 0, 0, 4, 4, 4, 4, 4, 4, 4, 4, 4, 4, 4, 4, 4, 0,
        0, 1, 2, 0, 4, 4, 4, 1, 1, 1, 0, 0, 0, 1, 1, 1, 1, 4, 0, 0, 0, 4, 1, 1, 1, 1, 1, 1, 1, 1, 1, 1, 1, 1, 1, 1, 1,
        0, 1, 1, 0, 1, 1, 1, 1, 2, 1, 0, 0, 0, 1, 1, 1, 1, 1, 4, 4, 4, 1, 1, 1, 1, 1, 1, 1, 1, 1, 1, 2, 1, 1, 1, 1, 0,
        0, 0, 0, 0, 1, 1, 1, 1, 1, 1, 4, 0, 4, 1, 2, 1, 1, 1, 1, 1, 1, 1, 1, 1, 2, 1, 1, 1, 1, 1, 1, 1, 1, 1, 1, 1, 0,
        0, 1, 1, 1, 1, 2, 1, 1, 1, 1, 1, 0, 1, 1, 1, 1, 1, 2, 1, 1, 1, 1, 1, 1, 1, 1, 1, 1, 1, 1, 1, 1, 1, 1, 1, 2, 0,
        0, 1, 1, 1, 1, 1, 1, 1, 1, 1, 1, 0, 1, 1, 1, 1, 0, 3, 1, 1, 1, 1, 1, 1, 1, 1, 1, 1, 1, 1, 1, 1, 1, 1, 1, 1, 0,
        0, 1, 1, 1, 1, 1, 1, 1, 1, 1, 1, 0, 1, 1, 1, 0, 0, 0, 3, 1, 2, 1, 1, 1, 1, 1, 1, 2, 1, 1, 2, 1, 1, 1, 1, 1, 0,
        0, 1, 1, 1, 1, 1, 1, 1, 1, 1, 1, 1, 1, 1, 1, 1, 0, 0, 0, 3, 1, 1, 1, 2, 1, 1, 1, 1, 1, 1, 1, 1, 1, 1, 1, 1, 0,
        0, 1, 1, 1, 1, 1, 2, 1, 1, 1, 1, 1, 1, 2, 1, 1, 0, 0, 0, 0, 3, 3, 1, 1, 1, 1, 1, 1, 1, 1, 1, 1, 1, 1, 1, 1, 0,
        0, 1, 1, 1, 1, 1, 1, 1, 2, 1, 1, 1, 1, 1, 1, 1, 0, 0, 0, 0, 0, 0, 1, 1, 1, 1, 1, 1, 1, 1, 1, 1, 1, 1, 2, 1, 0,
        0, 1, 1, 1, 1, 1, 1, 1, 1, 1, 1, 1, 2, 1, 1, 1, 0, 0, 0, 0, 0, 0, 1, 1, 1, 2, 1, 1, 1, 1, 1, 1, 2, 1, 1, 1, 0,
        0, 1, 1, 1, 1, 1, 1, 1, 1, 1, 1, 1, 1, 1, 1, 1, 0, 0, 0, 4, 4, 0, 0, 1, 1, 1, 1, 2, 1, 1, 1, 1, 1, 1, 2, 1, 0,
        0, 1, 1, 1, 1, 1, 1, 1, 1, 2, 1, 1, 1, 1, 2, 1, 0, 0, 0, 1, 1, 4, 1, 1, 1, 1, 1, 1, 1, 1, 1, 2, 1, 1, 1, 1, 0,
        0, 1, 1, 1, 1, 2, 1, 1, 1, 1, 1, 1, 1, 1, 1, 3, 0, 0, 4, 1, 1, 1, 1, 2, 1, 1, 1, 1, 1, 1, 1, 1, 1, 1, 1, 1, 0,
        0, 1, 1, 1, 1, 1, 1, 1, 2, 1, 1, 0, 2, 1, 1, 0, 0, 0, 3, 1, 0, 0, 1, 1, 1, 1, 1, 2, 1, 1, 2, 1, 1, 1, 2, 1, 0,
        0, 3, 2, 3, 3, 3, 3, 3, 3, 3, 3, 0, 3, 3, 3, 0, 0, 0, 0, 3, 3, 3, 3, 3, 3, 3, 3, 3, 3, 3, 3, 3, 3, 3, 3, 3, 0

    ],
    "id_nivel": "2"

}