{
    "gates": [{
        "x": 1184,
        "y": 32,
        "width": 32,
        "height": 32,
        "nivel_destino": "2",
        "destino_x": 0,
        "destino_y": -1
    }],
    "coins": [
        [1, 1],
        [34, 6],
        [8, 12],
        [14, 15],
        [21, 12],
        [5, 13]
    ],
    "tile_size": 32,
    "columnas": 36,
    "filas": 16,
    "mapa": [
        0, 0, 0, 0, 0, 0, 0, 0, 0, 0, 0, 0, 0, 0, 0, 0, 0, 0, 0, 0, 0, 0, 0, 0, 0, 0, 0, 0, 0, 0, 0, 0, 0, 0, 0, 0,
        0, 1, 1, 1, 1, 1, 1, 1, 1, 1, 1, 1, 1, 1, 1, 1, 1, 1, 1, 1, 1, 1, 1, 1, 1, 1, 1, 1, 1, 1, 1, 1, 1, 1, 1, 1,
        20, 2, 1, 1, 1, 1, 1, 1, 1, 1, 1, 1, 1, 1, 1, 1, 1, 1, 1, 1, 1, 1, 1, 1, 1, 1, 1, 1, 1, 1, 1, 1, 1, 1, 0, 0,
        20, 1, 1, 1, 1, 1, 0, 1, 1, 1, 1, 1, 1, 1, 1, 1, 1, 1, 1, 1, 1, 1, 1, 1, 1, 1, 1, 1, 1, 1, 1, 1, 1, 0, 0, 0,
        20, 1, 1, 1, 2, 1, 0, 0, 0, 0, 0, 0, 1, 1, 0, 1, 1, 1, 0, 1, 1, 1, 1, 1, 1, 1, 1, 1, 1, 1, 1, 1, 1, 1, 0, 21,
        0, 1, 1, 1, 1, 0, 0, 0, 0, 20, 0, 0, 0, 0, 0, 0, 0, 0, 0, 0, 0, 0, 0, 0, 0, 0, 0, 0, 0, 0, 0, 0, 0, 0, 0, 0,
        20, 1, 1, 1, 1, 1, 1, 1, 1, 0, 1, 1, 1, 1, 1, 1, 1, 1, 1, 0, 1, 1, 1, 4, 1, 1, 1, 1, 1, 1, 1, 1, 1, 0, 1, 0,
        0, 1, 1, 2, 1, 1, 1, 1, 1, 0, 1, 1, 1, 1, 1, 1, 1, 1, 1, 0, 1, 1, 1, 1, 1, 1, 1, 1, 1, 1, 1, 1, 1, 1, 1, 0,
        0, 1, 1, 1, 1, 1, 1, 1, 1, 1, 1, 1, 1, 1, 0, 1, 1, 1, 1, 1, 1, 2, 1, 1, 0, 1, 1, 1, 1, 1, 1, 2, 1, 1, 2, 20,
        19, 3, 3, 3, 3, 3, 0, 1, 1, 1, 1, 1, 1, 1, 0, 1, 1, 1, 1, 0, 3, 3, 3, 3, 0, 1, 1, 1, 1, 1, 1, 1, 1, 1, 1, 0,
        0, 0, 0, 0, 0, 0, 21, 0, 0, 0, 0, 0, 0, 0, 21, 0, 0, 0, 0, 0, 0, 0, 0, 0, 21, 0, 0, 0, 0, 1, 1, 1, 1, 1, 1, 0,
        0, 0, 0, 0, 0, 20, 21, 21, 0, 0, 0, 0, 20, 20, 20, 21, 0, 0, 0, 0, 0, 0, 20, 21, 20, 0, 0, 0, 0, 1, 1, 2, 1, 1, 1, 0,
        0, 4, 4, 4, 4, 0, 20, 0, 1, 1, 1, 1, 0, 20, 20, 0, 1, 1, 1, 1, 1, 1, 0, 0, 0, 4, 4, 4, 4, 1, 1, 1, 2, 1, 1, 21,
        0, 1, 1, 1, 1, 1, 0, 0, 1, 1, 1, 1, 1, 0, 20, 0, 1, 1, 1, 1, 1, 1, 1, 1, 1, 1, 1, 1, 1, 1, 1, 1, 1, 1, 1, 0,
        0, 1, 1, 1, 1, 1, 1, 1, 1, 0, 1, 1, 1, 1, 0, 1, 1, 1, 0, 0, 2, 1, 1, 0, 0, 1, 1, 1, 1, 1, 1, 2, 1, 1, 1, 0,
        20, 1, 1, 1, 1, 1, 1, 1, 0, 20, 1, 1, 1, 1, 1, 1, 1, 1, 0, 21, 3, 3, 3, 0, 0, 0, 0, 0, 0, 3, 3, 3, 3, 3, 3, 0,
        0, 0, 0, 0, 0, 0, 0, 0, 0, 21, 0, 0, 0, 0, 0, 0, 0, 0, 0, 20, 0, 0, 0, 0, 0, 0, 0, 0, 0, 0, 0, 0, 0, 0, 0, 0
    ],
    "id_nivel": "1"
}